#####################
S #     #           #
# ### ### ### ### ###
#       # # #   #   #
##### # # # # ### ###
#   # # #   #   #   #
### # # # # ### ### #
#   # #   # #   #   #
### ### # # ##### # #
#   #   # #   #   # #
### # ##### ##### # #
# # #   #     #   # #
# # ### # ######### #
#   #   #     # #   #
# ### ##### # # ### #
# #       # # #     #
# # ##### # ##### ###
#   # #   # # # #   #
# # # ### # # # # ###
# #     # #     #   E
#####################