S  ########################################################################################
         #     #                 #        #  #     #     #     #  #  #  #  #              #
#  #  ####  #  ####  #  ####  #  ####  ####  #  ####  #######  #  #  #  #  #  #  ####  ####
#  #  #     #  #     #  #     #              #  #              #        #  #  #  #        #
#  ##########  ####  ##########  ####  #######  ##########  #  #  #  ####  ##########  ####
#     #                    #     #  #        #  #        #  #     #  #  #  #        #     #
#  ##########  #######  ##########  ####  ####  #  #  ####  ####  ####  #  #  #######  #  #
#     #     #  #     #  #     #     #        #     #        #  #                 #  #  #  #
#  #######  #  #  ####  ####  ####  ##########  ####  #######  #  ####  ##########  ####  #
#  #              #  #           #  #           #              #     #           #        #
#  ####  ####  #  #  #  ####  #  #  #  #######  ####  #############  ####  #  #  ####  ####
#        #  #  #  #        #  #  #     #     #     #  #     #        #  #  #  #  #        #
####  ####  #  #  #  #  ####  #######  #  #  ####  ####  ####  #######  ####  #######  ####
#           #  #  #  #  #  #           #  #     #  #        #     #  #        #           #
################  #######  #######  ##########  #######  #  #  ####  #######  #  ##########
#     #        #     #     #     #  #  #           #  #  #        #           #        #  #
#  ####  #######  ####  ####  #######  #######  ####  #######  ####  #  ####  #  #######  #
#           #  #  #     #           #  #     #           #     #     #  #        #     #  #
#  #######  #  ####  #######  #  ####  ####  #######  #  #  ################  #  ####  #  #
#     #  #  #     #        #  #  #        #           #     #  #           #  #     #  #  #
#  ####  #  ####  #  #  ####  #  ####  ####  ####  ####  ####  #  #######  ##########  #  #
#     #              #        #        #  #  #  #     #  #  #     #        #     #        #
#  #  #######  #  ####  #  #  #######  #  #  #  ##########  #  #  ####  #######  #  #  ####
#  #  #     #  #  #     #  #  #  #  #  #           #  #  #  #  #  #  #              #  #  #
#######  ####  ################  #  #  ####  #  #  #  #  #  #  ####  #  #  #  #  #######  #
#        #  #              #     #  #  #     #  #  #  #  #        #     #  #  #  #  #     #
#######  #  #  #  #  ####  #  #  #  #  #  ####  ####  #  ####  ##########  #######  #  #  #
#              #  #  #  #  #  #  #        #              #        #     #  #           #  #
#  #  #  #############  #######  ####  #######  #  #  #######  ####  #  #  ####  #  #######
#  #  #     #     #  #  #  #           #     #  #  #                 #  #  #     #        #
#############  #  #  #  #  ####  #  #######  #  #######  ################  #  #  #  ####  #
#  #     #  #  #              #  #     #           #     #           #        #  #  #  #  #
#  #  #  #  ####  #  #  #############  ####  ####  ################  #  ##########  #  ####
#     #           #  #  #  #     #        #  #     #     #                 #              #
#  ##########  #  ####  #  #  ####  #  #######  ####  #######  #  ####  ####  #  ####  ####
#     #     #  #  #           #     #  #     #           #  #  #  #     #     #  #        #
#  #######  ####  ####  #  ##########  #  #  #  ####  #  #  #############  ####  #  #######
#     #           #  #  #  #  #  #     #  #     #     #           #        #  #  #     #  #
####  #  ####  ####  ####  #  #  ##########  ####  #######  ####  #######  #  ####  ####  #
#  #  #  #           #  #        #              #  #           #  #  #        #     #     #
#  ####  #######  ####  #  #  ####  #  #  #########################  ##########  ####  #  #
#  #     #     #  #  #     #        #  #              #           #     #  #           #  #
#  #  ####  #######  ##########  ####  ####  ####  ##########  ####  ####  #  #############
#        #                    #  #        #     #           #     #        #  #  #        #
####  #######  #  #  ####  #  ####  ##########  #  ##########  #######  ####  #  ####  ####
#  #        #  #  #  #  #  #        #           #     #                 #     #     #     #
#  #  #  #  ##########  #  #  #  #  #######  ####  #######  #  ################  #######  #
#  #  #  #  #     #        #  #  #        #     #  #  #     #        #     #  #           #
#  #  ##########  #  #  ##########  ####  #  #  #  #  #######  #######  #  #  ####  ####  #
#     #     #  #     #  #              #  #  #  #  #              #  #  #        #     #  #
#  #  #  ####  ##########  ######################  #  #############  ####  #############  #
#  #     #        #                       #  #  #     #     #     #     #        #        #
##########  #######  ##########  #  #######  #  #  ####  #  #  ####  ##########  #######  #
#           #  #        #  #  #  #  #           #     #  #        #     #  #              #
#  #  ####  #  ####  ####  #  ####  #  #  #######  #######  #  #######  #  ####  ##########
#  #  #     #     #  #     #     #  #  #     #     #     #  #              #              #
#  #  ####  #  #  ####  #  ####  #  ####  #######  #  #  #  ####  #  #  ####  ##########  #
#  #  #        #     #  #              #  #     #     #     #     #  #           #        #
#  #############  #  #######  ####  ####  #  #######  #  ####  ####  ####  #  ####  #  #  #
#           #     #              #           #        #     #     #     #  #  #     #  #  
########################################################################################  E