S  ████████████████████████████
   █           █  █     █     █
█  ██████████  █  █  █  █  █  █
█     █  █           █     █  █
█  ████  ██████████  █  █  █  █
█                 █  █  █  █  █
█  █████████████  ████  ███████
█  █     █     █  █           █
████  ███████  █  █  ███████  █
█     █     █     █        █  █
████  █  ████  █  ███████  █  █
█     █     █  █        █  █  █
█  █  █  █  █  █  ████  █  █  █
█  █  █  █     █  █  █  █  █  █
█  █  █  ████  ████  █  █  █  █
█  █  █     █  █  █  █     █  █
█  ████  ███████  █  █  ███████
█           █  █              █
█  ████  █  █  ████  ████  ████
█     █  █        █  █        
████████████████████████████  E