S  ██████████████████████████████████████████████████████████
   █     █     █  █  █  █  █     █        █                 █
█  █  █  ████  █  █  █  █  ████  █  █  ███████  ███████  ████
█     █  █                       █  █  █        █     █  █  █
████  ███████████████████  █  █  ████  █  █  ████  █  ████  █
█        █  █        █  █  █  █  █  █  █  █     █  █  █     █
█  ███████  ████  ████  █  ████  █  █  ████  ████  █  █  █  █
█     █  █              █     █              █     █     █  █
█  ████  █  ███████  █  ███████  ████  ████  █  █████████████
█     █  █  █        █     █     █     █           █        █
█  █  █  ████  ████████████████  ████  ███████  ████  ████  █
█  █        █        █     █     █  █  █  █        █  █     █
█  ███████  █  █  █  █  █  █  ████  █  █  ███████  ███████  █
█        █     █  █     █     █        █     █  █        █  █
█  ██████████  ████  ████  ████  ███████  ████  █  ███████  █
█     █           █     █  █  █        █                 █  █
█  ████████████████  ███████  ██████████████████████  █  █  █
█        █           █     █  █     █  █              █     █
█  ████  █  █  █  ███████  █  █  ████  ████  ██████████  ████
█     █  █  █  █  █        █     █  █           █           █
███████  █████████████  █  █  ████  ████  █  ████  ███████  █
█        █  █           █  █     █     █  █     █     █  █  █
███████  █  ████  ███████  █  ████  ████  █  █  ████  █  ████
█        █     █  █        █              █  █  █  █  █  █  █
█  ██████████  █  ███████  █  ████  ████  ████  █  ████  █  █
█     █        █        █        █     █  █           █     █
█  ███████  █  █  ███████  █  █  █  █  ███████  ██████████  █
█  █  █     █  █     █     █  █  █  █        █        █     █
████  █  ████  ████  ██████████  █  █  ████  ████  █  █  ████
█        █  █     █  █        █  █  █     █  █  █  █        █
█  ███████  █████████████  █  █  █████████████  █  ███████  █
█        █     █  █        █        █     █     █  █  █     █
███████  ████  █  ████  █  ███████  ████  █  ████  █  ████  █
█  █  █     █  █  █     █  █        █     █           █     █
█  █  █  ████  █  █  ███████  ███████  █  ██████████  ████  █
█                 █        █  █     █  █  █        █     █  █
█  ███████  ███████  █  █  ████  ███████  ████  █  █  ████  █
█  █  █  █        █  █  █     █        █        █  █  █  █  █
█  █  █  █  ██████████  ████  █  █  ████  █  ███████  █  ████
█     █                    █  █  █        █                 
██████████████████████████████████████████████████████████  E