S  ############################
   #           #  #     #     #
#  ##########  #  #  #  #  #  #
#     #  #           #     #  #
#  ####  ##########  #  #  #  #
#                 #  #  #  #  #
#  #############  ####  #######
#  #     #     #  #           #
####  #######  #  #  #######  #
#     #     #     #        #  #
####  #  ####  #  #######  #  #
#     #     #  #        #  #  #
#  #  #  #  #  #  ####  #  #  #
#  #  #  #     #  #  #  #  #  #
#  #  #  ####  ####  #  #  #  #
#  #  #     #  #  #  #     #  #
#  ####  #######  #  #  #######
#           #  #              #
#  ####  #  #  ####  ####  ####
#     #  #        #  #        
############################  E