S  #######
      #  #
#  ####  #
#        #
#  ####  #
#     #  
#######  E