#############################################################
S     #         #         # #         #       #       #     #
# # # ####### # ### # ### # ##### ### ##### # ##### ####### #
# # #   #     # # # #   # #         #       #         #     #
### # # # # # ### ### ##### ### # ##### ##### # ######### ###
# # # #   # #   #       # # #   #   #   #   # #             #
# ####### # # ######### # # # # ### ##### ### # # # # # # ###
#   #   # # #   #           # # # # #         # # # # # #   #
### # # ### ##### ### ######### # # ### # ##### # ### ### ###
#   # #   #     # # #   # #       #   # #   #   # # # # #   #
# ### ##### # ##### # ### # ####### ##### ### # # # ### # # #
# #   #     #   #         # #     # #     # # # # #   #   # #
# # # # # ### # ### ####### ### # ######### ####### #########
# # # # # #   # #       # # # # #     #   #   # #       # # #
# # ### # ####### ####### # # ####### ### # # # # ### ### # #
# # # # #       # #     #     #       # #   #     # #   #   #
# # # ### ### # # # ### ####### ### # # # ##### ### ### # ###
#   #       # #     # # # # # # #   #   #   # # #           #
# # # ############### # # # # # ### # ### # # ### # ### # # #
# #     #     #         #     #   # #   # #   #   # # # # # #
# # ######### ### ### # # # ####### # ####### ##### # # #####
# # #   #         #   #   #     #   # #   # #     #   #     #
# ### # ### ### ### ##### # ### # # # # # # ### # # ### # # #
#     # # #   # #       # # #   # # # # # #   # # # # # # # #
# # ### # # ####### ##### ####### # # # ### ### ### # # ### #
# # #   # # #   #   #   # #   # # # #           #   # # # # #
##### ### ##### ### ### ### ### # ##### ######### ### # # # #
# #   #     #   # # #           # # # # #       # #   # #   #
# ### # ##### ### # ### ### # ### # # ######### ##### # ### #
#   # #       # # # #     # # #     #   # #   #     #   #   #
### # ##### # # # ##### # ####### # # ### # # # # # # # #####
# # #   # # #           # # # #   # #     # #   # #   # # # #
# # # ### ##### ##### ##### # ### # ### ### ### ######### # #
#     #   #     #   # #     #   # #   # #     # #   # #   # #
##### # # # ### # # # ##### # # ##### # ### ##### ### # # # #
#     # #   #   # # # # #     #         #     # #   #   #   #
### # ####### ##### ### ########### # ##### ### # # # ### # #
#   #             #                 # # #       # #     # # #
# ##### # ####### # ### ########### ### # ### ##### ##### ###
# #   # # #   #     #   #   # # # # # #     #       # # #   #
# # # ### ### ### ### ##### # # # ### ### # ######### # # # #
#   #   # #       #     # #   #     #   # # #           # # #
##### # ### ### ### ##### ### # # ### # ### # ### # ####### #
#     # #     #   #     #       # #   #   #   #   #       # #
##### ### # # # # ### ##### ##### ### # ####### ##### ##### #
#       # # # # # #           # #   # # # #   #     #   # # #
# # # ####### ####### # # ### # ### # # # # ### ####### # # #
# # # #   #   #     # # #   #   # #   #     # #   #   #   # #
####### # # ### ##### ##### ### # # # ##### # ##### ### # ###
# #   # # #       #     #   # #   # #   #   # # #     # # # #
# # ### # ### ######### ##### ### # ##### # # # # # ### ### #
#     # #   # #         #     # # #     # #   #   #         #
# # ### # ### ### ### # # ##### ### ### # # ### # # # #######
# #   # # #   #   # # #   # #         # # #   # # # # #   # #
# ### # ##### # # # ### # # ####### # ##### ####### # ### # #
# #     #     # # #     # # # # #   # # # # # # #   #       #
##### # # ### ##### ####### # # ### ### # ### # # ######### #
#     #   # # # #       #     #           #   #         #   #
# ##### ### # # # ### ### # ##### # ### ### # ##### ##### ###
#   #     #     #   # #   #       #   #   # #       #       E
#############################################################