#####################################################################################################
S     #     # #         #     #     #   # #   #         #           # #     #     # #   # # # #     #
# ### # ### # # # ##### ### # ### # # # # # # # ##### ### ##### ### # # ####### # # ### # # # ##### #
#   # # #   # # # #   # # # #     #   # #   #       #     # #   #   #     #     # #   #             #
# ##### # # # # ##### # # ### ####### # ####### ##### # ### ### ### ### ##### ####### ### # ### # # #
# #   # # # #     #         # #       # #     # #     # # #   #   #   #   # #     #       # #   # # #
# # ### ### # ### ### ### ####### ##### ##### ### # ### # # # ### # ### ### ### # ### ###############
#       # #     #   # #   #   # #     #   #     # #   #   # #   # #             # #   # #   #     # #
# ####### ######### # ### # # # ### # ### # ### # # # # # ### ######### ### ##### # # # # ##### ### #
#   #       # #     # # #   # #     # # # #   # # # # # #           #   #     #     #       #   #   #
# ### ### ### # # ##### # # # ### ### # # ### # ##### # ### ### # # ##### # # # ####### ### ### # ###
#     #     # # # #       # # #     # #       # # #   # #   # # # #     # # # # # #       #   #     #
##### ### ### # ####### ### ################# # # ####### # # ### # ##### ##### # ### ####### ##### #
#       #   # # #     # #     #       #       # #   # #   #     # # #   #   # #     # #         #   #
### # ##### # ### ### ############### ##### ####### # ### ##### ##### ##### # ##### ### # ##### # # #
#   #   #       # #   #   #   #     # # # # #         #   #     #     #       #     # # #     # # # #
##### ### ##### ##### # ##### ### ### # # # # # # ########### ### ### # ##### ### ### # ### ####### #
#       #     # #   #     #   #     #         # # # #   # #     # # #     #   #       # #     #     #
### # ####### ### # # ####### ### # # ########### # # ### ### # ### # ### # ### ### ######### # ### #
#   #   #         #   # # # #   # #       #   #   #     #   # # #   #   # #   # #       #   #     # #
# # ##### # # ######### # # # ####### # ### ### # ##### # ### ##### ####### # ##### ### # ##### ### #
# # #   # # # # # #   #       #     # #   #   # # #   #       # # #         # # #   #   #   #     # #
### ### # ### # # # ##### # ### # # ##### # ### ##### # # # # # # # # ### ##### ### ##### ### # ### #
#     # # #       # #     # #   # #   #       #         # # # #     #   # # #     #     #   # # #   #
# # ### # ### ### # # # # ### # ### ##### ### ### ##### ### # ######### ### ### ##### ##### ####### #
# #   # # #     #     # #     # # #   #     #   #   #     # # #       #   #       #   #   #       # #
# # ### ##### ### # # ####### ### ############# ######### # ##### # ### ### ########### # # #########
# #   #   #     # # # #   # #     #   # #         # #     # # # # #     #     #         #         # #
##### ### # ### ### ### ### ##### ### # ### ##### # ##### # # # # # # # # ####### # ##### ##### ### #
#   # #   #   # # #           # # #   # #     # # # #     #     # # # # #   #     #   # #     #   # #
# # # # ### # ### ####### ##### ### ### ##### # ### # # ############### ### ### ##### # ##### ### # #
# #     # # # # # # #   #     # # # #   # # # #     # # # # # #   #     # #     #       #       # # #
# # ### # ### # # # ### # ### # # # # ### # ### # ### ### # # # ### ##### # # # # ### ##### # ##### #
# # #       #           #   #   # #   #   #   # # # #   #     #           # # # # # #   #   # #   # #
##### # ####### ##### # ####### # # ### # # ### # # ### ##### ####### ##### ####### # # ##### # # # #
# # # #   #   # #   # #   # #   # # #   #     # #         #   # #   # # # #         # # #     # #   #
# # ####### # # # ### ##### ##### # # ### ### ####### ####### # # ### # # ### ##### ####### # ##### #
#   #     # #       #     #       # #   # #     #           #               #   #         # #       #
# # ### # ### # # ### ######### # # ##### ### ##### ######### # # # ##### ##### # ####### # #########
# #     #   # # # #       #   # #   # # # # #   #   # #   #   # # # # #   #     #       # #   # #   #
# ### ### # # ####### # ##### # ##### # # # ####### # ### # ####### # ### # # ### # ### # ##### # # #
# # # # # # # # #   # #   #   #     # #   #         # #       #   #   # #   # # # #   # # #   #   # #
# # # # ### # # ### ##### # ### ##### ### # ### ##### ### ##### ### ### # ##### # ######### ### # ###
# #   # #   #   #     # #                 # # # #   # # #       #     # #       # #   #   #   # #   #
##### # # # # ####### # ### ### ############# ### ### # # ### ######### # ######### # # # # ####### #
#   #   # #   # #         #   # #       #   #     # #     #   #     #     #         #   # #   #     #
### # ### ##### # ##### ######### ### # # # ### ### ##### ### # ### ####### # ##### ######### # # # #
#     #   # #   # #       #     #   # #   #   #       #   #   # # #   #   # #     #             # # #
##### ### # # ########### ### ### ### ########### ##### ######### ### # ##### ##### ####### # ##### #
#     #   #   # #         #       # # # # #   #     #         #         #   # #   #     # # # #     #
# ### # ### ### ####### # # ##### # # # # # # ### ##### # ### ### ### ##### ### # # ### # ####### # #
#   # #   # #     #     #       #   # # #   #       #   #   #     #   # #       # #   #   #       # #
### ### # # ### ####### ##### ######### ### ### # # # # ##### ### ##### # ##### ##### # # # ### ### #
#   #   #   # # #     #     #   # #   # # # #   # #   #   #   #         # #         # # # # #   #   #
### ##### ### # # ####### ##### # # ### # ####### # ##### ####### ### ### # # ##### ##### ### ##### #
#   #       # #   # #     #   #     #   #         # # # #   #       #     # # #       # #   #     # #
# ####### # # ### # ##### # ##### # # # # ########### # ### ################### ##### # # ### ### # #
#   # # # # #     #       #     # #   #           #       # #   #   #   # #       #       # # # # # #
# ### # # # ##### ### ##### # ########### ### # # ##### ####### # # # # # ### ##### # ### # ### #####
# #     # # # #     #     # #       #     #   # #   # #         # #   # #   # #     # #     #   #   #
### # ### ### # ##### # ### # ### # ##### ### ####### ### # ####### ### # ### ##### ##### # # ### # #
#   #   #   #     #   #     # # # #   # # #     #     # # #   #   # # #   #   #   #     # #     # # #
##### ### ### ####### # # ### # ####### # ######### ### ### # # # ### # ### ### ### ########### ### #
#         # #         # #   #     #       #   #     # # # # # # #     #   #     #   #     # # #   # #
# ####### # ####### # # # ### ####### # ##### ##### # # # ### ##### ### ### # ####### ### # # # ### #
# #   # # #     #   # # # # #   # # # #     #   #     #   #   # #   #       #     # # # #   #   # # #
### ### # ### ### ### ##### # # # # ##### ### ### ##### # ### # # # # # # # # ### # # # # ####### # #
#     #     # #     #       # #   #     #           #   #       # #   # # # # #   #     #     # #   #
##### # ##### ##### ### ### # ####### ### ######### ### ### # ### # ##### ##### ##### # # ### # # # #
#     # #           #   #   # #     # # #   #       #     # #     #     # #   # #   # # # #     # # #
# # ### ### ### ##### # # ##### # ### # # # ### ######### ##### ##### ####### ##### ####### ### # ###
# # #         # # #   # # # # # # #   #   # #   #     # #     #     #     # #   # #     # # #       #
# ####### ### ### # ### ### # ### ### ### ### ##### ### ##### ### ### # ### # ### # ##### ### ### # #
# #     # # # # # # #     #       #       #   # #   #   #     #     # # #   # #   # #     #   #   # #
# # ### # # ### # # ########### ######### ##### # ### ### # ### # ### # ### # ### # # # ######### ###
#   # # # #   #                 #       #   # #   # # # # #   # #   # #   #       #   # # #   #     #
##### # # ### ######### # ####### # # ### ### ### # # # ### ### ### ### # ### # # ### # # # # # ### #
#         # #       # # # # #     # #     #       #     #     #   # # # #   # # #     #   # #   #   #
# # ##### # # ##### # # ### # # ##### ######### ####### # ### # ##### ##### # ##### ### ### ####### #
# # #   # # #   # #   #     # #   #   #   # #   #     # # #   #         #       # # #   #   #       #
### ### ### ### # # ##### # ##### ### ### # # # ### # # ##### # ####### ####### # ############# # ###
#   #   # # # # # #   #   # #     # # #       #   # # #   #   # #     # #   #     # #       # # #   #
# ##### # # # # # ### # ### ####### # ##### # # ### # ### # ##### ### # # ##### ### # ### ### # ### #
# #       #   #   #   # #   #   # #   # #   # # # # # #       #     # # #   #     #   #     # # #   #
# # ### ### # ##### ### ##### ### ### # ### # # # # ### ####### ##### # ### # ### # ### ##### ##### #
#     # # # #   #       #   # #   # #     # # # #         # # # #       # #   #     # # #           #
# ####### ##### ### # # # ### ### # # ### # ##### # ##### # # # ######### ######### # ####### ##### #
#     # #       #   # #         #       # #   # # #   # #     # #     # #                       #   #
### ### ### ####### ### ##### ### ##### ### # # # ##### # ##### # ##### ########### ####### # ### # #
#   #   # # # #   # #   #       # # #     # #     #         #       #       #     #     #   # #   # #
####### # # # ### ####### ##### ### ### # # # # ### ########### ### ####### # ### # ### # # ### ### #
# #     #   #         #   #   #   # # # # # # # # #       #       # #       #   # #   # # #   #   # #
# # # ### ### # ####### ### # # # # # ######### # ### ####### ### # ##### # ##### # ### ### ### # ###
#   #       # #       #   # # # #   #   #   # #   # # # #   #   # # #     # #   # #   # #     # #   #
# ### # ### # # ### # # ### ########### # ### # # # # # # ### # ######### ##### # # # ### ####### ###
# # # #   #   # #   # # # #                 #   # #       #   #                 #   # #   # # # # # #
# # ### ### ### ### # # # # # ##### ####### ######### ### ##### # ##### ### ####### ####### # # # # #
#   #     #   #   # # #   # #   #     # # #       # # # # #     # #       #   #       #     # #   # #
# # # ######### # ### ### # # ##### # # # ##### # # ### # ##### ######### # ##### # # # # ### # ### #
# # # #         # #       # #     # # #         #             #     #     # #     # #   #     #     E
#####################################################################################################