█████████████████████████████████████████
S █             █                       █
█ █ █ █████ ███████████ █ ███ ███████████
█ █ █ █   █ █     █   █ █   █       █   █
█ ███ █ ███ ███ █ █ ███ █████ █ ███████ █
█     █   █     █ █     █     █   █     █
███ █████ █████ █ █████ █ █████ █ █████ █
█   █ █   █     █ █   █ █ █   █ █   █   █
█ ███ █ █████ █████ █ ███ █ █ █ ███ █ █ █
█ █     █   █ █     █   █ █ █ █ █     █ █
█ █ ███████ █ █ █ █ ███ █ █ █████ █ █ █ █
█   █     █ █   █ █   █ █       █ █ █ █ █
█████████ █ ███████████ █ █████ ███ █ █ █
█ █ █   █     █     █ █     █   █   █ █ █
█ █ ███ █████ █ █ ███ █ ███ ███████████ █
█ █       █     █     █ █   █           █
█ █ █████ █████████ █████ █████ ███████ █
█     █   █ █   █ █ █   █ █ █ █   █     █
█ █████████ ███ █ █ ███ █ █ █ ███████ ███
█   █ █   █                     █ █     █
█ ███ █ █ █ █████████ █████████ █ ███ ███
█ █ █ █ █ █   █ █ █       █ █   █ █     █
█ █ █ █ ███████ █ █████████ █ ███ █████ █
█ █       █   █   █     █         █   █ █
█ █ █████ █ ███ █ █ ███ █████ █ █ █ █████
█     █ █ █     █   █     █   █ █       █
█ █████ ███ █ █████████ █ █████ ███ █ █ █
█     █     █   █   █   █ █   █ █   █ █ █
█ ███ █ █████ ███ █ ███████ ███ ███████ █
█   █ █     █ █   █ █ █         █ █     █
█ ███ █ ███ ███ █ ███ █ █ ███ ███ █ ███ █
█ █     █ █   █ █     █ █ █ █ █ █   █   █
█ ███ ███ ███ ███████ █ █ █ █ █ ███████ █
█ █       █   █         █   █ █ █       █
█ █ ███ █ █████████ █ ███ ███ █ █ █████ █
█ █ █   █ █   █ █   █   █ █     █     █ █
█████ ███ █ ███ █ ███ ███████ █ ███████ █
█   █   █         █   █ █ █   █ █ █   █ █
█ █ █ ███████ █████ ███ █ ███ ███ ███ █ █
█ █   █         █       █     █         E
█████████████████████████████████████████