#########################################
S #             #                       #
# # # ##### ########### # ### ###########
# # # #   # #     #   # #   #       #   #
# ### # ### ### # # ### ##### # ####### #
#     #   #     # #     #     #   #     #
### ##### ##### # ##### # ##### # ##### #
#   # #   #     # #   # # #   # #   #   #
# ### # ##### ##### # ### # # # ### # # #
# #     #   # #     #   # # # # #     # #
# # ####### # # # # ### # # ##### # # # #
#   #     # #   # #   # #       # # # # #
######### # ########### # ##### ### # # #
# # #   #     #     # #     #   #   # # #
# # ### ##### # # ### # ### ########### #
# #       #     #     # #   #           #
# # ##### ######### ##### ##### ####### #
#     #   # #   # # #   # # # #   #     #
# ######### ### # # ### # # # ####### ###
#   # #   #                     # #     #
# ### # # # ######### ######### # ### ###
# # # # # #   # # #       # #   # #     #
# # # # ####### # ######### # ### ##### #
# #       #   #   #     #         #   # #
# # ##### # ### # # ### ##### # # # #####
#     # # #     #   #     #   # #       #
# ##### ### # ######### # ##### ### # # #
#     #     #   #   #   # #   # #   # # #
# ### # ##### ### # ####### ### ####### #
#   # #     # #   # # #         # #     #
# ### # ### ### # ### # # ### ### # ### #
# #     # #   # #     # # # # # #   #   #
# ### ### ### ####### # # # # # ####### #
# #       #   #         #   # # #       #
# # ### # ######### # ### ### # # ##### #
# # #   # #   # #   #   # #     #     # #
##### ### # ### # ### ####### # ####### #
#   #   #         #   # # #   # # #   # #
# # # ####### ##### ### # ### ### ### # #
# #   #         #       #     #         E
#########################################