█████████████████████
S █     █           █
█ ███ ███ ███ ███ ███
█       █ █ █   █   █
█████ █ █ █ █ ███ ███
█   █ █ █   █   █   █
███ █ █ █ █ ███ ███ █
█   █ █   █ █   █   █
███ ███ █ █ █████ █ █
█   █   █ █   █   █ █
███ █ █████ █████ █ █
█ █ █   █     █   █ █
█ █ ███ █ █████████ █
█   █   █     █ █   █
█ ███ █████ █ █ ███ █
█ █       █ █ █     █
█ █ █████ █ █████ ███
█   █ █   █ █ █ █   █
█ █ █ ███ █ █ █ █ ███
█ █     █ █     █   E
█████████████████████