########
S  ##  E
## ### #
#      #
########